 20 14
GGGGGGGGGGGGGGGGGGGG 
G                  G
G                  G
G                  G
G                  G
G     GGGGGGG      G
G     G     G      G
G     G     G      G
G     GG   GG      G
G                  G
G                  G
G                  G
G                  G
GGGGGGGGGGGGGGGGGGGG
      